[INFO]
# mapRows	mapColumns	tileWidth	tileHeight	tileColumns	tileRows
7	24	32	32	8	5
[TILE_MAP]
0	0	0	0	0	0	0	0	0	0	0	0	0	0	0	0	0	0	0	0	0	0	0	0	
1	2	2	2	2	2	3	3	1	2	2	2	2	2	3	3	3	3	3	3	4	5	5	6	
7	8	7	7	7	7	9	9	7	8	7	7	7	7	9	9	9	9	10	10	11	12	13	14	
8	15	8	8	8	8	8	8	8	15	8	8	8	8	8	8	8	8	15	15	16	17	13	18	
19	20	15	19	19	15	19	15	19	20	15	19	19	15	19	15	15	15	20	0	21	22	23	24	
25	26	27	25	25	27	25	27	25	26	27	25	25	27	25	27	27	28	26	29	30	31	32	33	
34	34	34	34	34	34	34	34	34	34	34	34	34	34	34	34	34	34	34	34	34	34	34	34	