6	24
32	32
0	1	2	3	1	4	4	4	5	5	4	4	4	4	4	4	4	4	4	4	4	5	5	0	
6	7	7	8	7	9	9	9	10	11	9	9	9	9	12	13	13	13	13	14	15	16	17	6	
6	7	18	19	20	9	21	22	23	24	25	9	9	13	26	17	17	27	28	29	30	31	7	32	
6	7	33	34	35	14	36	37	38	39	7	25	12	27	40	41	7	42	43	44	31	7	45	46	
6	20	47	18	18	48	48	49	50	50	51	20	34	52	50	25	7	23	24	53	20	54	55	6	
56	56	57	58	58	59	60	60	60	59	61	60	62	63	60	64	64	63	61	60	60	62	62	56	
