[INFO]
# mapRows	mapColumns	tileWidth	tileHeight	tileColumns	tileRows
6	24	32	32	8	5
[TILE_MAP]
0	1	2	3	4	5	6	7	8	9	10	11	12	13	14	15	8	16	17	18	13	19	20	21	
22	23	24	25	26	27	28	29	30	31	32	33	34	35	36	37	38	31	39	34	31	40	41	42	
43	44	45	46	47	48	49	50	51	52	53	54	55	56	57	58	59	60	61	62	52	63	64	65	
66	67	68	69	70	71	72	73	74	75	76	77	78	79	80	81	82	83	84	85	86	87	88	89	
90	91	92	67	93	64	94	77	95	96	23	97	98	96	77	99	93	100	100	100	101	102	103	104	
105	106	107	108	109	110	111	109	109	109	109	109	109	109	109	109	109	109	109	109	110	112	112	112	
