[INFO]
# mapRows	mapColumns	tileWidth	tileHeight	tileColumns	tileRows
6	16	32	32	9	6
[TILE_MAP]
0	1	2	3	4	5	6	7	3	8	6	3	4	8	6	9	
10	11	12	13	14	15	16	16	13	17	18	13	14	19	18	20	
21	18	22	23	24	18	25	26	27	28	16	29	30	31	18	20	
32	12	30	13	20	18	12	20	32	25	14	20	11	33	34	20	
32	19	11	13	20	18	15	20	32	18	35	36	37	38	13	20	
39	40	41	42	43	41	41	43	39	41	41	41	44	41	42	43	
